1111111111111
1C000000000P1
10C0000000001
100C000000001
1000C00000001
10000C00000E1
1111111111111