1111111
1C00P01
10C0001
100C001
1000C01
1E000C1
1111111