1111111111111
1C00000000001
10C0000000001
100C0000P0001
1000C00000001
10000C00000E1
1111111111111