1111111111111
1C00000000001
1011111111101
101C0000P0101
1011111111101
1C100C00000E1
1111111111111