1111111111111111111111111111111
100C000C00000000C00001000C00001
1011111111111111111101011011101
1C000C000C000000000001C100C0001
1010111111111111110101010111101
101C100C0000C000C001000P0000C01
1C10101111111111111101111111101
11100C1001111100000C000C000C001
111C1111C000000CCC010C010111111
1C0000011111010CCC0111110111111
111111C000C0010000000C00000E0C1
1111111111111111111111111111111