

1111111111111
1000000E00001
10000000P0001
10000000C0001
100E000000001
1000000000001
1111111111111