11111111111111111111111111
1C000000000000000000000001
10C00000000000000000000001
100C000000000000000P000001
1000C000000000000000000001
10000C00000E00000000000001
11111111111111111111111111